10 10 5 8 9 5
11 10 12 13 9 10 10 10 14 13 
11 14 1 0 6 11 12 15 15 5 
13 15 7 7 15 11 6 11 14 5 
5 11 10 14 11 14 15 11 12 5 
5 13 15 15 15 9 10 12 5 5 
1 6 15 15 15 5 13 7 3 4 
1 10 14 11 14 7 7 15 9 4 
3 14 13 11 12 9 14 15 5 5 
9 14 7 13 1 0 12 13 7 5 
7 11 10 6 7 7 3 2 10 6 
