10 10 0 2 1 9
9 14 11 10 10 12 15 11 8 14 
5 15 11 14 9 6 11 14 3 12 
3 14 15 9 0 10 10 12 13 5 
13 9 10 6 3 12 15 3 6 7 
5 7 11 10 10 4 15 15 15 13 
5 15 11 8 12 7 11 12 13 5 
5 9 12 1 0 8 12 7 7 7 
5 3 2 6 5 1 4 13 9 14 
7 15 15 15 3 4 1 4 3 14 
15 15 15 15 15 3 2 2 10 14 
