15 15 10 12 2 13
11 8 14 9 10 10 8 14 11 10 10 10 8 8 14 
11 6 15 1 10 10 6 15 15 15 9 10 4 7 13 
9 8 14 7 15 13 15 15 11 10 6 15 1 8 4 
1 6 9 14 15 1 8 10 14 9 14 13 1 2 4 
1 12 5 15 15 1 4 15 15 7 15 5 7 9 6 
7 1 6 13 15 7 3 12 11 10 14 5 13 3 12 
11 6 13 5 15 13 11 2 10 14 11 0 0 14 5 
15 9 4 5 15 7 15 13 9 14 13 3 2 12 5 
13 3 2 6 11 14 13 1 2 14 7 13 11 6 5 
5 15 15 13 15 11 0 6 15 11 8 0 14 9 6 
5 15 15 3 12 15 3 14 11 12 3 6 9 2 12 
5 9 14 9 4 15 15 15 11 4 11 14 7 15 5 
5 7 11 2 6 9 14 13 11 2 14 15 9 8 4 
1 10 8 14 13 1 12 1 12 11 8 8 2 4 5 
7 11 2 10 6 3 2 2 2 14 7 7 11 6 7 
