15 15 12 0 7 3
13 11 10 10 10 12 11 8 8 14 9 10 14 15 13 
5 11 12 9 14 7 11 4 5 9 6 13 13 13 5 
1 8 6 7 11 14 13 7 5 3 14 1 6 7 5 
7 1 10 12 13 15 5 11 4 11 12 5 11 10 4 
9 0 10 6 3 14 5 11 4 9 2 6 15 15 5 
5 5 9 14 13 13 3 14 3 6 15 15 13 13 7 
5 3 2 8 6 3 14 11 12 15 11 14 7 7 13 
3 12 11 4 13 13 13 15 7 13 15 11 12 13 5 
9 6 15 7 7 5 3 8 14 3 14 15 1 2 4 
5 15 11 14 11 4 13 7 15 15 13 15 7 11 4 
5 15 15 15 15 1 6 9 14 15 1 10 14 11 4 
5 15 15 15 15 3 12 7 13 13 7 11 14 11 4 
1 12 9 10 8 14 7 13 7 3 14 11 14 9 6 
5 3 6 9 6 11 12 1 14 15 15 11 12 5 15 
3 10 14 3 10 10 2 2 10 10 10 10 6 3 14 
