15 60 7 31 13 49
11 8 14 9 10 8 10 8 10 14 11 14 11 10 8 8 14 13 13 11 10 10 12 13 15 15 9 10 12 15 11 10 10 10 12 13 11 12 9 14 9 12 15 9 10 10 10 10 10 10 10 12 9 14 9 14 13 13 11 12 
9 6 13 7 15 7 11 6 9 12 13 15 13 9 6 7 11 4 5 13 11 10 2 6 15 15 5 15 7 13 13 13 9 10 2 6 15 5 5 15 5 5 13 5 9 10 10 10 10 8 14 7 7 11 0 14 7 3 12 7 
5 11 6 13 9 8 12 13 7 7 1 10 4 7 13 13 11 2 0 2 12 15 11 10 14 15 5 13 15 7 7 3 2 8 14 9 14 7 7 11 4 7 7 3 2 14 11 14 15 7 15 15 11 14 1 10 12 11 4 13 
5 11 10 2 6 5 7 3 8 10 6 15 7 9 2 4 11 8 0 12 3 12 13 9 14 11 6 5 9 14 15 11 12 7 13 5 15 15 13 15 5 11 8 10 14 13 11 12 11 10 14 13 9 10 6 11 0 10 4 5 
7 9 14 11 14 5 11 14 7 15 15 11 10 2 8 4 15 7 5 1 10 6 3 2 12 15 11 6 1 10 10 12 7 15 3 6 11 12 7 11 6 11 6 13 13 5 15 1 10 10 14 5 7 13 11 12 1 12 1 6 
13 7 15 13 15 3 8 10 8 12 13 13 13 15 5 1 14 11 6 5 9 8 10 12 7 13 13 9 4 13 15 3 10 12 15 15 11 2 10 10 8 14 15 7 7 7 11 6 9 14 9 0 12 1 10 4 7 3 4 13 
5 11 12 3 10 14 7 11 6 7 7 3 6 13 7 3 12 13 11 2 6 5 11 2 14 3 6 5 7 7 11 12 15 3 10 12 9 14 9 14 1 14 13 15 13 15 15 13 5 15 7 5 3 2 12 3 14 9 4 5 
7 11 6 15 11 14 13 13 15 15 13 13 11 0 8 8 4 3 10 12 13 5 9 14 15 15 9 4 15 13 11 0 10 10 8 6 5 15 3 14 5 13 7 15 7 11 14 7 7 9 14 3 12 11 4 13 13 7 5 5 
13 11 14 13 9 14 5 7 15 11 6 1 14 5 7 5 1 14 13 7 7 5 3 14 15 15 7 3 14 5 11 6 15 9 2 10 2 10 10 12 7 7 13 15 13 13 15 11 14 3 12 15 7 15 1 4 3 12 7 5 
7 13 15 5 7 13 5 11 14 11 10 2 10 4 15 7 7 15 7 9 10 6 11 8 12 9 8 8 10 2 14 9 10 6 13 15 13 11 10 0 10 10 6 9 0 6 15 15 9 14 3 8 14 11 6 3 12 3 14 5 
15 7 9 4 15 3 6 11 14 11 8 14 11 4 13 15 15 15 15 5 15 15 11 6 3 4 7 7 13 15 11 2 12 15 7 15 7 15 15 1 10 12 11 6 3 10 12 15 3 8 14 7 15 11 10 14 7 9 14 5 
13 13 7 7 15 13 11 8 8 10 0 14 15 5 5 15 11 10 14 3 8 10 14 15 13 7 13 15 7 15 13 15 7 15 15 15 11 8 14 5 11 6 15 11 14 15 3 12 11 2 10 14 15 15 15 9 8 4 11 6 
5 7 9 14 15 7 15 7 5 15 7 11 12 5 7 15 13 15 9 12 3 10 14 9 2 14 5 9 14 15 7 15 11 8 10 10 12 3 10 4 15 13 15 11 12 13 11 6 13 15 15 11 12 11 8 6 5 5 15 13 
3 14 7 11 14 15 13 15 7 15 15 11 2 0 14 11 2 14 7 3 14 15 13 7 11 12 7 5 13 13 11 10 12 3 14 9 6 13 11 4 13 5 15 11 6 5 13 11 4 9 10 10 6 9 0 14 7 5 15 5 
15 11 14 11 10 10 2 14 11 14 11 10 10 2 10 10 10 14 11 10 10 10 2 10 10 2 10 6 3 6 15 11 2 14 11 2 14 3 10 2 2 2 14 11 10 6 3 10 6 3 10 10 10 6 7 11 10 6 11 6 
