7 7 3 1 5 6
11 8 14 11 10 14 13 
11 4 13 11 10 10 4 
13 1 2 12 11 12 5 
3 6 13 3 8 0 4 
9 8 6 13 7 5 5 
5 3 14 7 13 7 7 
3 10 10 14 3 10 14 
