15 60 36 11 10 2
9 12 9 10 8 8 8 8 10 10 8 10 14 9 8 10 14 11 14 11 10 10 8 8 12 15 9 10 10 8 14 13 13 11 10 10 10 8 10 10 14 9 14 11 10 10 10 14 11 10 10 10 10 10 8 8 10 14 15 15 
1 6 7 13 3 6 1 2 14 15 5 15 11 6 1 10 12 15 11 14 11 12 7 7 3 12 5 15 15 3 14 5 5 15 15 11 14 3 14 15 13 1 12 13 11 12 15 15 13 9 10 12 15 11 4 7 13 15 11 14 
5 15 11 6 13 9 0 14 11 14 7 9 12 15 7 15 1 10 8 14 15 7 13 15 11 0 0 10 10 14 9 6 5 9 14 15 15 9 12 13 1 2 2 6 15 7 13 15 1 6 9 4 13 11 2 12 5 13 15 13 
3 14 13 11 6 5 1 10 14 11 12 1 2 14 15 13 3 12 7 11 8 10 4 15 13 3 2 12 9 14 1 12 7 1 14 9 14 7 3 6 7 15 15 13 11 12 1 14 1 14 7 7 1 10 8 6 7 7 9 4 
13 15 7 13 11 4 3 10 10 14 3 2 10 14 11 4 15 5 13 15 3 12 3 14 1 14 13 5 7 15 1 6 15 7 15 5 11 8 14 15 13 11 8 6 9 6 3 8 6 9 14 11 2 12 7 15 15 11 6 5 
3 8 8 4 9 2 12 13 9 8 14 11 14 15 9 6 11 2 2 10 12 5 15 9 4 11 4 5 9 14 7 15 15 15 13 7 9 6 15 13 3 8 2 8 0 14 9 6 9 6 15 9 10 6 11 12 11 10 10 4 
13 7 7 1 6 11 0 4 7 1 10 14 15 13 3 10 14 13 13 13 7 5 11 0 6 9 4 3 6 15 15 11 14 15 5 9 6 13 15 1 10 6 13 7 5 11 6 13 5 15 9 0 14 15 9 4 15 11 10 4 
5 15 11 6 13 11 4 7 11 4 15 15 15 7 9 12 13 7 7 5 13 5 11 6 15 1 4 9 10 14 15 15 15 9 0 0 12 5 13 5 13 11 0 14 1 14 9 4 7 13 1 6 13 11 6 3 14 15 15 5 
7 9 12 11 2 10 4 15 15 5 15 9 12 13 3 6 7 11 10 6 3 6 11 10 14 7 7 7 13 15 13 11 8 6 7 7 7 7 3 2 4 15 7 15 7 11 2 6 11 0 6 15 5 15 15 15 13 11 12 5 
9 4 5 9 8 10 4 13 15 7 9 4 7 3 10 14 11 12 11 14 15 15 15 11 14 15 13 15 7 11 6 11 2 12 13 15 13 15 9 8 4 11 10 14 15 13 15 11 8 2 14 11 6 15 15 15 3 10 6 5 
5 7 5 7 7 13 1 4 13 15 3 6 13 11 14 15 15 7 15 11 8 10 14 15 13 13 5 15 11 10 8 14 13 5 3 14 7 13 3 4 5 15 9 12 15 1 10 14 3 14 15 13 13 15 9 12 9 12 13 5 
3 10 6 15 15 3 6 3 0 10 10 12 1 12 11 12 9 14 15 13 5 11 14 15 7 5 7 11 10 14 1 12 3 6 15 9 12 1 12 1 6 13 3 4 9 6 13 13 11 10 12 3 6 15 3 2 2 0 4 5 
13 11 14 11 14 9 14 13 5 13 13 5 7 7 15 5 7 15 11 4 3 14 13 15 11 6 11 12 15 11 6 7 15 9 10 4 7 3 6 1 14 7 11 0 4 9 4 3 14 11 6 15 15 11 12 15 15 3 2 4 
1 12 15 11 10 4 9 4 1 4 7 3 14 15 15 7 15 11 12 5 13 13 7 11 14 9 10 6 9 14 11 14 11 6 9 6 13 15 11 4 13 11 12 5 7 7 7 11 12 13 11 14 15 9 0 14 15 15 9 6 
7 7 11 14 15 7 3 2 2 2 10 10 10 10 10 10 10 14 3 2 2 2 10 10 14 3 10 10 6 11 10 10 10 14 7 15 7 15 15 3 2 10 6 7 11 10 10 10 2 2 14 11 10 2 2 10 10 10 2 14 
