10 60 20 3 43 6
15 15 9 10 8 8 10 10 10 8 10 8 12 9 8 10 8 10 8 14 11 8 12 11 10 8 8 10 10 8 10 14 13 15 9 14 11 10 10 8 10 10 10 8 8 10 10 8 14 9 14 11 8 12 9 8 10 12 15 13 
13 15 1 14 1 6 13 11 10 0 14 5 3 0 4 11 2 14 7 13 15 7 7 13 15 3 6 11 14 3 14 13 1 12 7 11 12 15 11 2 12 11 12 7 3 12 15 7 15 3 12 15 7 1 6 5 11 6 15 5 
5 13 7 13 7 13 7 11 12 5 11 4 15 7 7 11 10 14 13 5 13 15 11 2 10 14 9 10 12 11 10 2 2 2 14 15 7 15 15 9 2 8 4 15 15 3 12 13 11 12 7 11 12 5 13 5 15 13 13 5 
1 0 14 3 8 4 13 15 7 7 9 6 15 13 13 15 13 15 3 4 5 9 8 10 10 14 7 9 2 12 13 11 8 14 15 9 14 11 14 7 15 5 5 11 14 11 2 6 15 5 15 15 7 1 6 5 15 3 2 4 
1 4 13 11 4 3 6 11 10 10 2 14 15 7 1 12 3 12 13 3 6 7 7 13 9 10 14 3 14 5 3 14 7 9 14 5 13 15 15 15 15 3 4 13 13 15 13 13 15 3 10 14 9 6 11 6 13 15 15 5 
5 7 7 15 1 10 10 12 13 15 15 15 13 9 2 6 15 7 5 15 11 14 13 5 3 12 15 13 15 5 9 14 13 5 9 6 3 12 11 12 15 15 5 3 6 11 2 0 14 13 15 15 3 10 12 13 5 9 8 6 
7 11 10 12 1 10 10 6 7 15 11 10 0 0 10 10 8 8 6 9 14 11 2 4 9 0 14 7 13 7 5 15 3 4 5 15 13 7 11 0 8 14 3 8 14 15 15 5 11 6 11 10 12 11 4 5 3 6 3 14 
9 8 10 4 3 10 14 11 14 13 9 8 2 0 8 14 7 1 14 1 14 15 11 6 5 5 15 9 4 13 7 13 15 7 3 12 3 10 12 5 7 9 14 3 14 15 15 7 15 11 12 9 2 14 7 7 13 9 12 15 
3 2 14 7 11 8 12 9 14 7 3 0 14 3 4 13 13 5 9 4 13 15 11 14 7 7 13 3 6 3 8 2 10 8 8 2 14 15 7 5 13 1 14 13 13 11 14 11 8 10 6 7 13 15 15 15 7 3 2 14 
11 10 10 14 11 2 6 3 14 11 10 6 11 10 2 2 2 6 3 6 3 10 10 10 14 15 3 10 10 10 2 10 10 6 3 10 10 10 10 2 2 6 11 6 3 14 11 14 3 10 10 14 3 14 11 10 14 11 14 15 
