15 15 5 8 4 12
15 11 10 14 9 10 10 14 11 10 8 14 15 13 13 
11 14 15 11 2 14 15 11 14 13 5 13 15 3 4 
11 14 13 15 15 15 13 9 12 1 4 3 8 14 7 
9 12 1 14 11 8 2 6 3 0 6 11 4 15 13 
5 1 4 15 9 2 14 13 15 7 13 13 7 13 7 
1 0 0 14 7 13 11 6 13 13 7 5 15 7 13 
7 5 3 10 8 6 15 15 5 7 11 6 11 12 5 
9 0 12 9 6 9 14 11 6 15 15 9 14 3 6 
1 4 7 1 14 3 12 13 9 10 10 6 13 11 14 
3 2 10 2 12 13 1 0 6 15 15 13 3 14 15 
13 15 9 10 0 2 0 6 15 9 14 1 14 15 13 
3 14 7 9 2 10 2 8 8 4 9 2 10 10 6 
13 15 13 1 8 14 13 5 7 1 0 8 10 12 15 
1 10 6 5 3 14 3 4 11 6 5 7 15 7 13 
3 10 10 2 10 14 11 6 11 10 6 15 15 11 6 
