15 15 8 13 5 0
15 13 11 10 10 10 10 8 8 10 12 9 14 11 12 
13 3 14 15 11 8 10 0 2 10 6 7 11 14 5 
3 14 15 13 13 3 10 0 14 13 15 9 8 10 4 
9 10 14 5 3 14 9 0 14 5 15 7 3 12 5 
3 12 13 7 9 12 7 7 15 7 9 14 9 2 6 
15 7 5 11 6 5 15 11 14 13 3 10 6 15 15 
9 10 6 15 15 5 15 13 11 2 14 9 10 14 13 
5 11 12 15 15 1 12 5 15 15 15 7 11 10 6 
5 9 2 14 11 4 3 2 14 9 14 11 14 15 15 
5 1 12 11 14 3 10 8 14 7 15 9 12 15 13 
5 1 2 14 15 11 10 6 15 13 13 5 5 15 7 
5 7 15 15 9 10 14 13 9 6 7 7 1 10 12 
5 11 14 13 5 15 15 7 5 11 10 14 7 15 5 
1 12 13 3 6 11 14 11 4 11 8 14 11 10 6 
7 3 2 14 11 10 10 10 2 10 2 10 14 15 15 
