25 20 13 2 19 12
13 11 10 10 8 8 8 14 11 8 10 8 8 10 10 10 8 10 10 12 
5 15 11 12 3 2 6 13 15 1 8 4 3 12 15 11 4 11 10 6 
7 11 12 5 15 11 10 4 11 6 1 4 15 1 8 14 7 11 12 13 
13 9 0 2 12 9 8 2 14 11 6 3 14 5 7 15 13 15 7 5 
5 3 0 10 6 7 3 14 15 9 14 11 10 0 10 14 7 11 8 4 
5 15 1 8 14 11 12 9 8 2 14 15 11 4 9 12 9 14 3 4 
5 11 0 4 13 13 5 5 3 12 15 15 11 4 3 2 4 9 8 4 
7 11 6 7 1 6 7 7 11 0 14 11 12 5 15 9 2 6 5 5 
9 8 14 9 6 13 13 11 14 7 15 15 1 0 14 5 13 15 5 5 
5 7 15 7 15 3 0 12 15 11 10 14 5 7 15 7 7 11 6 5 
5 15 15 9 14 13 5 5 11 8 10 14 5 15 11 14 13 15 15 5 
7 11 14 3 8 4 7 7 15 5 11 14 3 14 11 10 0 14 13 5 
13 15 15 9 6 1 10 8 14 3 8 10 10 14 9 8 6 11 6 5 
1 12 11 6 15 7 15 7 15 15 1 12 11 10 2 2 10 14 11 4 
5 5 15 11 14 9 12 11 10 14 5 7 11 14 15 9 8 10 10 4 
1 0 12 11 8 0 0 12 11 14 7 15 13 13 15 5 5 9 14 7 
1 6 5 15 5 3 0 0 10 14 11 14 7 7 11 0 2 2 14 13 
3 8 4 15 7 11 2 0 14 11 10 14 13 15 13 7 15 11 12 7 
13 3 4 15 11 12 11 4 11 12 15 15 5 13 5 9 12 9 6 13 
5 9 6 13 15 1 8 2 10 2 10 8 0 6 7 3 4 1 14 5 
1 2 10 4 11 2 6 15 9 12 13 7 3 12 15 15 7 7 9 4 
5 13 15 5 15 15 9 10 2 2 0 14 15 7 13 13 15 9 6 7 
3 2 14 1 14 13 7 15 15 15 7 13 9 14 3 2 12 5 13 15 
13 15 15 5 11 6 15 11 8 10 14 7 7 11 10 12 3 4 7 13 
3 10 10 2 10 10 10 10 6 11 10 10 14 15 11 2 10 2 10 6 
