10 10 5 0 6 3
11 10 14 11 10 10 14 11 14 13 
15 15 11 14 15 15 13 15 11 6 
13 15 9 14 15 15 5 11 10 12 
5 11 6 11 12 11 6 15 13 5 
5 13 15 15 7 11 14 9 2 4 
5 7 15 11 12 11 14 3 12 5 
1 12 13 11 4 13 15 9 6 5 
5 1 6 11 6 7 15 1 14 5 
5 7 9 14 9 12 11 6 9 6 
7 11 2 10 6 7 15 11 2 14 
