8 10 9 1 6 2
11 8 14 9 14 9 10 10 14 13 
13 3 12 3 12 3 8 14 13 5 
5 13 7 15 5 11 0 14 1 6 
5 7 11 10 2 14 5 13 5 15 
5 13 11 8 12 15 5 1 0 12 
7 5 11 2 2 10 6 1 4 5 
9 4 13 11 12 15 13 7 3 6 
3 2 2 10 2 10 2 10 10 14 
