10 60 3 10 6 16
15 11 10 10 10 10 10 8 10 8 8 14 11 10 8 10 8 8 10 10 12 15 11 10 12 9 8 10 8 10 10 12 13 13 11 10 10 14 15 11 8 10 14 9 10 10 10 12 9 14 11 10 12 13 11 8 8 14 15 13 
9 12 9 10 10 8 12 5 15 7 3 14 15 11 6 15 7 3 10 8 2 14 15 15 1 6 3 12 7 11 14 7 3 6 15 15 15 11 12 15 7 15 15 7 11 8 14 7 7 13 15 15 3 4 11 6 3 12 9 4 
5 7 3 10 12 7 5 1 8 14 11 8 10 14 13 11 12 11 10 4 13 13 9 14 7 13 15 7 15 11 14 15 15 9 8 10 14 13 5 11 14 13 13 11 14 1 14 11 12 7 13 11 10 6 15 11 14 7 7 7 
3 12 11 14 3 12 7 7 3 8 10 6 9 14 1 14 7 11 12 3 6 7 5 13 15 7 13 9 12 9 14 11 10 6 7 9 10 2 6 9 12 5 7 15 9 2 10 14 1 14 7 15 13 15 15 13 11 14 13 13 
9 6 9 10 10 4 11 14 11 6 15 15 7 13 7 13 15 15 1 12 15 13 5 7 15 15 5 7 7 1 14 11 8 8 10 0 14 13 15 7 3 6 13 9 0 12 9 10 2 12 9 12 7 13 11 2 10 10 2 4 
1 10 6 15 15 5 13 15 13 13 13 9 14 7 11 4 9 14 7 5 9 6 3 14 13 15 1 8 14 5 11 14 7 1 8 6 15 7 15 13 15 13 3 4 7 7 3 8 10 0 6 5 15 5 11 8 10 12 13 7 
7 15 13 15 15 7 7 9 4 7 7 3 14 11 10 0 6 15 15 5 5 15 11 14 3 10 6 1 10 4 13 11 8 4 7 13 15 9 8 2 12 7 15 7 15 15 9 4 15 5 11 4 15 3 12 3 14 1 2 12 
13 9 6 9 12 15 15 5 7 13 11 8 14 11 14 7 15 15 15 1 0 10 10 14 11 10 8 6 11 6 7 15 7 7 13 1 10 4 5 13 7 13 9 14 9 14 5 3 10 4 13 5 11 10 6 9 8 2 12 5 
5 7 13 5 3 10 8 6 11 6 11 6 15 13 15 15 11 14 11 6 3 10 10 14 15 11 2 8 14 9 10 14 13 15 7 3 10 2 2 4 13 7 7 13 5 15 1 14 15 5 3 0 14 15 15 7 5 11 4 7 
7 11 2 6 11 14 7 11 10 10 14 11 10 2 10 10 10 10 10 10 14 11 10 14 11 10 10 2 10 2 10 10 2 14 11 10 10 10 14 3 6 11 14 3 6 11 2 14 15 3 14 3 10 10 10 14 7 11 2 14 
