10 10 4 5 2 5
4 5 0 5 0 11 11 0 13 4 
10 9 9 6 10 12 10 0 8 13 
9 4 10 5 0 1 11 14 14 11 
0 3 1 0 8 1 11 3 1 9 
7 11 2 1 2 12 13 12 13 5 
9 6 10 4 12 10 5 7 9 3 
2 9 6 3 9 14 4 5 2 6 
14 9 1 0 10 3 12 8 15 9 
13 9 0 7 13 12 2 2 3 11 
5 5 4 12 9 13 10 13 2 12 
