10 10 8 0 2 4
9 10 12 11 10 10 10 10 12 13 
5 13 1 14 11 10 12 13 5 5 
5 1 0 8 14 15 7 5 7 5 
1 4 1 4 15 11 10 2 10 4 
1 6 5 3 10 10 10 10 14 5 
1 10 4 15 15 11 14 11 8 4 
5 11 2 14 15 13 15 13 1 4 
5 11 10 8 14 5 13 7 7 5 
7 15 13 7 11 6 7 11 10 6 
15 11 2 10 10 10 14 11 10 14 
