10 10 1 2 1 1
11 10 10 14 15 11 10 10 8 12 
13 15 11 12 13 13 11 14 7 7 
3 10 8 6 5 3 10 10 10 12 
15 11 4 15 3 14 11 14 15 5 
15 13 5 15 13 15 15 11 14 5 
13 1 4 13 7 15 15 11 14 5 
7 1 0 2 12 15 15 11 10 4 
9 0 6 11 6 13 15 13 15 7 
5 1 10 14 11 2 10 6 15 15 
7 3 10 10 10 10 10 10 10 14 
